11111111111111
11111110000001
1C000000000001
1110000C000011
10000011100001
1C0E0011C0C0P1
11111111111111