11111111111111
11111110000001
1100000C000001
10000011100001
1CE0001C00C0P1
11111111111111