1111111111111111111111111111111111111111111111111111
10100000000C0000000000000000000000111111000000000001
1000011111111000000000000000000000011100000000000001
1000110000000000000000000000000C00001000011111111111
1000110000000000000000000001111111111111000000000001
1000110000000111111111100000111111000000000000000001
1000110000000000000000000000001100000000000000000001
1000111111111111000000000000001000000000000000000001
1000110000000000000000000000000000000000000000000001
1000110000000011111111110000000000011111111111111111
1000110000CCC00000C00000C000000000000000000000000111
100011C000111111111111111000000011111111111110000001
1000111000000000000001111000000000000000000000000001
1000111100000000000000001111100000000000010000000001
1000111111111110000000000000000000000001111C00000001
1000110000000000000000000000001111111111111111111111
100011100000000000C000000000000000000000000000000001
1001111000000011111111111111111110000000000000000P01
1E0000000M0000000000001111000C0000000111111111111111
1111111111111111111111111111111111111111111111111111