111111111111111111
100100000000001001
100000000000000001
100000000000000001
10C00C000000000001
111001000C000C0001
10P011M1M10M01M1E1
111111111111111111