11111111111111
11E1C000000001
10000011100001
100000100000P1
11111111111111