11111111111111
1101000C000001
10000011100001
10E0001000C0P1
11111111111111