1111111111111111111111111111111111111111111111111111
10100000000C0000000000000000000000111111000000000001
1000011111111000000000000000000000011100000000000001
1P00110000000000000000000000000C00001000000000000001
1000110000000000000000000001111111111111000000000001
1000110000000000000000000000111111000000000000000001
1000110000000000000000000000001100000000000000000001
1000110000000000000000000000001000000000000000000001
1000110000000000000000000000000000000000000000000001
1000110000000000000000000000000000011111111111111111
1000110000CCC00000C000000000000000000000000000000111
1000111111111111111111111000000000000000000000000001
1000110000000000000000000000000000000000000000000001
1000110000000000000000000000000000000000000000000001
1000110000000000000000000000000000000000000000000001
1000110000000000000000000000001111111111111111111111
100011100000000000C000000000000000000000000000000001
1001111000000011111111111111111110000000000000000001
1E111111000000000000001111000C0000000000000000000001
1111111111111111111111111111111111111111111111111111