1111111111
11E1C00001
1000000001
10000010P1
1111111111